XXXXXXXXXXXXXXXX
X              X
X  XX    XX    X
X  XX    XX    X
X              X
X      XX      X
X      XX      X
X              X
X  XXXXXXXX    X
X              X
XXXXXXXXXXXXXXXX
